###############################################################
#      #                                   #                  #
#      #                                   #                  #
#      ######   #######   #######   ########                  #
#      #                                   #                  #
#      #                                   #                  #
#      ######   #######   #######   ########          #       #
#                                                     #       #
#       #          #         #         #              #       #
#       #          #         #         #              #       #
#       #          #         #         #              #       #
#                                                     #       #
#      ######################################         #       #
#      #      #     #     #     #     #     #                 #
#      #      #     #     #     #     #     #                 #
#      #   #     #     #     #     #     #                    #
#      #   #     #     #     #     #     #                    #
###############################################################
