####################################..............................####################################.
#                                  #..............................#                                  #.
#                                  #..............................#                                  #.
#                                  #..............................#                                  #.
#                                  #..............................#                                  #.
#                                  #..............................#                                  #.
#                                  #..............................#                                  #.
#                                  #..............................#                                  #.
#                                  #..............................#                                  #.
#                                  #..............................#                                  #.
#                                  ################################                                  #.
#                                                                                                    #.
#                                                                                                    #.
#                                                                                                    #.
#                                                                                                    #.
#                                                                                                    #.
#######################                                                       ########################.
......................#                                                       #........................
......................#                                                       #........................
......................#                                                       #........................
......................#                                                       #........................
......................#                                                       #........................
......................#                                                       #........................
......................#                                                       #........................
......................#                                                       #........................
......................#                                                       #........................
......................#                                                       #........................
......................#                                                       #........................
......................#                                                       #........................
......................#                                                       #........................
......................#                                                       #........................
......................#                                                       #........................
#######################                                                       ########################.
#                                                                                                    #.
#                                                                                                    #.
#                                                                                                    #.
#                                                                                                    #.
#                                  ################################                                  #.
#                                  #..............................#                                  #.
#                                  #..............................#                                  #.
#                                  #..............................#                                  #.
#                                  #..............................#                                  #.
#                                  #..............................#                                  #.
#                                  #..............................#                                  #.
#                                  #..............................#                                  #.
#                                  #..............................#                                  #.
#                                  #..............................#                                  #.
#                                  #..............................#                                  #.
####################################..............................####################################.
